[
    [
        { "x": 2, "y": 2 },
        { "x": 10, "y": 2 },
        { "x": 2, "y": 6 },
        { "x": 10, "y": 6 },
        { "x": 6, "y": 4 }
    ],
    [
        { "x": 2, "y": 6 },
        { "x": 4, "y": 5 },
        { "x": 6, "y": 4 },
        { "x": 8, "y": 3 },
        { "x": 10, "y": 2 }
    ]
]
